1-1-1-1-1-1-1-1-1-1-1-1-1-1-1-1-1-1-1-1-1-1-1-1-1-1-1-1-1-1-1-1-1-1-1-1-1-1-1-1-1-1-1-1-1-1-1-1-1-1-
----------------------------------------------------------------------------------------------------
1-00000000001-000000T=00000000000000000000000000000000000000000000000000000000000000000000000000001-
--0P00000000--000000==0000000000000000000000000000000000000000000000000000000000000000000000000000--
1-00000000001-00000Z1-0000000000001-1-1-1-1-1-1-1-1-1-1-1-1-1-1-1-1-1-1-1-1-1-1-1-1-1-1-1-1-A=1-1-1-
--0000000000--00000R--000000001-00------------------------------------------------------------------
1-0Z000000001-0000001-00000000--0000000000000000001-0000000000000000000000000000000000001-000000001-
--0000000000--000000--000000001-000000000000000000--00000B000000000000000000000000000000--00000000--
1-A=1-1-1-1-1-1-1-1-1-00000000--0000000000000000001-0000000000000000000000000000000000001-000000001-
--00------------------000000001-00000000E000000000--00000X000000000000000E00000000000000--00000000--
1-0000000000000000000000000000--0000000000000000001-00000000000000000000000000000000000000000000001-
--00000000000000000000000000001-000000000000000R00--0000000000000000000000000000000000000000000Z00--
1-0000000000000000000000000000--0000000000000000001-00000000000000000000000000000000000000000000001-
--001-1-1-1-1-1-1-1-1-1-1-1-1-1-1-1-1-1-1-1-1-1-1-1-1-1-A=1-1-1-1-1-1-1-1-1-1-1-1-1-1-1-1-1-1-1-1---
1-00----------------------------------------------------------------------------------------------1-
--000000000000000000000000000000000000000000000000000000000000000000000000000000000000000000000000--
1-0000000000000000000000000000000000000000000000000000000000000000000000000000000000000000000000001-
--1-1-1-1-1-1-1-1-1-1-1-1-1-1-1-1-1-001-001-001-001-001-001-1-1-1-1-1-1-1-1-001-1-1-1-1-1-1-1-1-1---
1-----------------------------------00--00--00--00--00--00------------------00--------------------1-
--R000000000000000000000000000001-000000000000000000000000001-000000000000000000000000000000000000--
1-000000000000000000000000000000--00000000000000000000000000--0000000000000000000000000000000000001-
--000000000000E000000000000000001-00000000000000E000000000001-00000000000000000000000000000000000--
1-000000000000000000000000000000--00000000000000000000000000--00000000000000E0000000000000000000001-
--0000000000000000000000000000001-000000000000000000000000001-00C0000000000000000X00000000000Z0000--
1-000000000000000000000000000000--00000000000000000000000000--0000000000000000000000000000000000001-
--1-1-1-1-1-1-1-1-1-1-1-1-1-D=1-1-1-1-1-1-S=1-1-1-1-1-1-1-1-1-1-1-1-1-1-1-1-1-1-1-1-1-1-1-1-1-1-1---
1---------------------------00------------00------------------------------------------------------1-
--000000000000000000000000000000T=000000000000001-000000000000000000000000000000000000000000000000--
1-000000000000000000000000000000==00000000000000--0000000000000000000000000000000000000000000000001-
--00B0000000000000000000000000001-000000000000001-000000000000000000000000000000000000000000000000--
1-000000000000000000000000000000--00000000000000--0000000000000000000000000000000000000000000000001-
--1-1-1-D=1-1-1-1-1-1-1-1-1-1-1-1-000000000000001-001-1-1-1-1-1-1-1-1-1-0000001-1-1-1-1-1-1-1-1-1---
1-------00------------------------00000000000000--00--------------------000000--------------------1-
--0000000000000000000000000000001-000000000000001-001-0000000000000000000000001-000000000000000000--
1-000000000000000000000000000000--00000000000000--00--000000000000000000000000--00000000000000R0001-
--000000000000000000E000000000001-0000000000000000001-00000000000000001-00000000000000000000000000--
1-0000000000000000000000000000000--000000000000000000--0000000000000000--00000000000000000000000001-
--0000000000000000000000000000001-1-1-1-1-1-1-1-1-1-1-1-1-1-1-1-1-1-1-1-1-1-1-1-1-1-1-A=1-1-1-1-1---
1-000000C00000000000000000000000------------------------------------------------------S=----------1-
--0000000000000000000000000000001-0000000000001-0000000000000000000000000000001-000000T=0000000000--
1-1-1-1-1-1-1-1-1-00000000000000--000000000000--000000000000000000000000000000--000000==00000000001-
------------------0000000E0000001-00000X00000T=T=0000000000000000000000M0000001-000000000000000000--
1-000000000000001-00000000000000--00000000000====00000000000000000000000000000--0000000000000000001-
--000B000000R000--000000000000001-0000000000001-0000000000000000000000000000001-000000000000000R00--
1-000000000000001-0000000E000000--000000000000--000000000000000000000000000000--0000000000000000001-
--00000000000000--000000000000001-1-1-1-001-1-1-1-1-1-1-D=1-1-1-1-1-1-1-1-1-1-1-1-1-1-D=1-T=1-1-1---
1-000000000000000000000000000000--------00--------------S=----------------------------00--==------1-
--00000000000000000000000000000000000000000000000000000000000000000000001-000000000000000000000000--
1-000000000000001-0000000000000000000000000000000000000000000000000E0000--0000000000000000000000001-
--00000000000000--0000000000000000000000000000000000000000000000000000001-000000000000000000000000--
1-1-1-1-1-1-1-1-1-000000000000000000E00000000000000000000000000000000000--0000000000000000000000001-
------------------00000000000000000000000000000000000E0000000000000000001-000000000000000000000000--
1-0000000000000000000000000000000000000000000000000000000000000000000000000000000000R00000000000001-
--000000000000000000000000000000000000000000000000000000000000000000000000000000000000000000000000--
1-1-1-1-1-1-1-1-1-1-1-1-1-1-1-1-1-1-1-1-1-1-1-1-1-1-1-1-1-1-1-1-1-1-1-1-1-1-1-1-1-1-1-1-1-1-1-1-1-1-
----------------------------------------------------------------------------------------------------