1-1-1-1-1-1-1-1-1-1-1-1-1-1-1-1-1-1-1-1-1-1-1-1-1-1-1-1-1-1-1-1-1-1-1-1-1-1-1-1-1-1-
------------------------------------------------------------------------------------
1-000Z0000001-00000000000000000000000000R01-000000000000000000000000000000000000001-
--0000000000--0000000000000000000000000000--0000000000000000000000000000000B000000--
1-000000P0001-00Z000000E0000000000000000001-0000000000000000000000000000000X0000001-
--0000000000--0000000000000000000000000000--00000000000000000000000000000000000000--
1-00000000001-000000000E0000000000000000001-1-1-1-1-A=1-1-1-1-1-1-1-1-1-1-1-1-1-1-1-
--0000000000--0000000000000000000000000000----------00------0000000000000000000000--
1-A=1-1-1-1-1-1-1-1-1-1-1-1-001-1-1-1-1-1-1-000000000000001-0000000000B000000000001-
--00------------------------00--------------00000000000000--0000000000000000000000--
1-000000000000000000000000000000000000000000000000000000001-00000000000000000000001-
--00000000000000000000000000000000000000000000000000000000--0000000000E00000000000--
1-1-1-1-1-1-1-1-1-1-1-1-1-1-1-1-1-1-1-1-1-1-S=1-1-1-1-1-1-1-00000000000000000000001-
--------------------------------------------00--------------0000000000000000000000--
1-00000000001-00000000000E0000R001-0000000000000000000001-1-1-1-1-1-1-D=1-1-1-1-1-1-
--0000000000--00X0000000000000000--000000000000000000000--------------00------------
1-00000000001-000000000001-1-1-1-1-0000000000000000000001-0000000000000000000000001-
--0000000000--00000000000----------000000000000000000000--000000000000000000000000--
1-00000000001-0000000000000000000000000000000000000000001-0000000000000000000000001-
--0000000000--000000000000000000000000000000000000000000--000000000000000000000000--
1-00000000001-1-1-1-1-1-1-1-1-1-1-1-1-1-001-1-1-1-1-1-1-1-1-1-1-1-1-1-D=1-1-1-1-1-1-
--0000000000----------------------------00----------------------------00------------
1-000000000000000000000000000000000000000000000000000000000000000000000000000000001-
--00000000000000000000000000000000000000000000000000000000000000000000000000000000--
1-00000000001-1-1-1-1-1-1-1-1-1-1-1-1-1-001-1-1-1-1-1-1-1-1-1-1-1-1-1-1-1-1-1-1-1-1-
--0000000000----------------------------S=------------------------------------------
1-00000000001-000000000000000000000000000000000000000000000000000000000000000000001-
--0000E00000--00000000000000000000000000000000000000000000000000000000000000000000--
1-00000000001-00000000000000000000000000000000000000000000000000000001-1-1-1-1-0001-
--0000000000--0000000000000000000000000000000000000000000000000000000--00000000000--
1-00000000001-1-1-1-1-1-1-1-1-1-1-1-1-1-1-1-00000000000000000000000001-000000000001-
--0T=000T=00--------------------------------0000000000000000000000000--00E0000E000--
1-0==000==001-00000000000000000000000000000000000000000000000000000001-000000000001-
--0000000000--0000000E00000000000000000000000000000000000000000000000--00000000000--
1-00000B0000T=00000000000000000000000000000000000000000000000000000001-000000000001-
--0000000000==0000000000000000000000000000000000000000000000000000000--00000000000--
1-00000000001-0000001-1-1-1-1-1-1-1-1-1-1-1-1-1-1-1-1-1-1-T=1-1-1-1-1-1-1-1-1-1-001-
--0T=000T=00--000000--------------------------------------==--------------------00--
1-0==000==001-000000E0000001-00000000000000000000000000000000000000000000000001-001-
--0000000000--0000000000000--0000000000000000000000000000000000000000000000000--00--
1-00000000001-000C0000000000000000000000000000000000000000C000000000000001-00000001-
--00000M0000--000000000000000000000000000000000000000000000000000000000000--000000--
1-1-1-1-1-1-1-1-1-1-1-1-1-1-1-1-1-1-1-1-1-1-1-1-1-1-1-1-1-1-1-1-1-1-1-1-1-1-1-1-1-1-
------------------------------------------------------------------------------------

